1111111111111111111111111111
100000000010100000C000000101
1P00110000C00000100000010001
1001110000000100000111001001
100000000010100000C000000101
1000110010C00100100000010001
10011100C1000100000111001001
100000001010100000C000000101
1111110000C00100100000010001
100000000000010E000111001001
1111111111111111111111111111